+--+--+--+--+--+--+--+--+--+--+--+--+--+--+--+--+--+--+--+--+  +--+--+--+--+--+--+--+--+--+--+--+--+--+--+--+--+--+--+--+--+
|                          |        |           |                 |                                                     |  |
+  +--+--+--+--+--+--+--+  +  +--+  +  +  +--+  +  +--+--+--+--+  +--+--+--+--+--+  +--+--+--+--+--+--+--+--+--+--+--+  +  +
|  |                    |  |     |     |     |  |  |  |           |                 |     |  |                       |     |
+  +--+--+  +--+--+  +  +  +--+  +--+--+--+  +  +  +  +  +--+--+--+  +--+--+--+--+--+  +  +  +  +--+--+  +--+--+--+  +--+  +
|        |        |  |  |     |           |  |     |  |           |     |        |     |     |  |        |              |  |
+  +--+  +--+  +--+  +  +--+  +--+--+  +--+  +--+--+  +--+--+--+  +  +  +  +--+  +  +  +--+--+  +  +--+--+--+--+--+--+  +  +
|     |  |     |     |     |  |        |     |     |        |     |  |  |     |  |  |     |     |                 |     |  |
+--+  +  +  +--+  +--+--+--+  +  +--+--+  +--+  +  +  +--+  +  +--+  +  +  +  +--+  +--+  +  +--+--+--+--+--+--+  +--+--+  +
|     |  |  |  |              |        |  |  |  |     |     |     |  |  |  |        |  |     |                 |           |
+  +--+  +  +  +--+--+--+--+--+--+  +--+  +  +  +--+--+  +--+--+  +--+  +  +--+--+--+  +--+--+--+--+--+--+--+  +--+--+--+--+
|  |     |        |              |  |     |  |        |        |        |  |                                         |     |
+--+  +--+  +--+--+  +--+--+  +--+  +  +--+  +--+--+  +--+  +--+--+--+--+  +  +  +--+--+--+--+--+--+--+--+--+--+--+  +  +  +
|     |     |     |     |  |     |  |  |        |     |  |     |        |  |  |  |                    |     |        |  |  |
+  +--+--+  +  +  +--+  +  +--+  +  +  +  +  +--+  +--+  +--+  +  +--+  +  +--+  +  +  +--+--+--+--+  +  +  +  +--+--+  +  +
|        |  |  |  |     |     |     |  |  |                 |     |  |     |     |  |        |           |  |           |  |
+  +--+  +--+  +  +  +--+  +  +--+--+  +--+--+--+  +--+--+--+  +--+  +--+--+  +--+  +--+--+  +--+--+--+--+  +--+--+--+--+  +
|     |        |     |     |  |     |     |     |  |        |                 |  |        |        |        |     |     |  |
+--+  +--+--+--+--+--+--+  +  +  +  +--+  +  +  +--+  +--+  +--+--+--+--+--+--+  +--+--+  +--+--+  +--+  +--+  +  +  +  +  +
|  |                       |     |     |  |  |           |  |     |              |     |     |  |     |     |  |     |     |
+  +--+--+--+--+--+--+--+--+--+--+--+  +  +  +--+--+--+--+  +  +  +  +--+  +--+  +  +--+--+  +  +--+  +--+  +  +--+--+--+--+
|           |              |     |     |     |     |        |  |     |     |     |        |  |     |  |  |  |              |
+  +  +--+  +  +--+--+--+  +  +  +  +--+--+--+  +  +  +--+--+--+  +--+  +--+  +--+  +  +  +  +--+  +  +  +  +--+--+--+--+  +
|  |     |  |        |  |  |  |  |              |  |           |     |  |  |  |     |  |  |        |  |              |     |
+  +--+  +--+--+--+  +  +  +  +  +--+--+--+--+--+  +--+--+--+  +  +--+  +  +  +--+--+  +  +--+--+  +  +--+--+--+--+  +  +--+
|     |           |  |  |  |  |           |              |     |  |     |     |        |  |        |  |           |  |  |  |
+--+  +--+  +--+  +  +  +  +  +--+--+  +  +  +--+--+--+--+  +--+  +  +--+  +--+  +--+--+  +  +--+--+  +  +--+--+  +--+  +  +
|     |     |     |     |     |  |     |  |     |           |     |     |  |     |     |  |        |     |     |        |  |
+  +--+  +--+  +--+--+  +--+--+  +  +--+--+  +--+  +  +--+--+  +--+--+  +  +  +--+  +  +  +--+--+  +--+--+  +--+--+--+--+  +
|  |     |  |        |           |  |        |     |  |     |     |     |     |  |  |  |        |  |                       |
+  +  +--+  +--+--+  +--+  +--+--+  +  +--+--+  +--+--+  +  +--+--+  +--+--+--+  +  +  +--+--+  +  +--+--+--+  +--+--+--+  +
|  |     |              |  |        |        |           |        |  |        |     |        |  |  |           |           |
+  +--+  +  +--+--+--+--+  +  +--+--+--+--+  +--+--+--+--+--+--+  +  +  +--+  +--+--+  +--+--+  +  +  +--+--+--+  +--+--+--+
|  |     |  |        |     |  |           |  |        |           |     |  |        |           |     |        |        |  |
+  +  +--+--+  +--+  +  +--+  +  +--+  +--+  +  +--+  +  +--+--+--+  +--+  +--+--+  +--+--+  +--+--+--+  +--+  +--+--+  +  +
|  |              |  |     |  |     |     |  |  |     |  |        |              |        |        |     |        |     |  |
+--+--+--+--+--+--+  +--+  +  +--+  +--+  +  +  +  +--+  +  +  +  +--+--+--+--+  +--+--+  +--+--+  +--+--+  +--+  +  +--+  +
|                    |     |  |     |  |  |     |     |  |  |  |  |           |        |  |                 |     |        |
+  +--+--+--+--+--+  +  +--+  +  +--+  +  +  +--+--+--+  +  +  +  +  +--+  +  +--+--+  +  +--+--+--+--+--+--+--+--+--+--+  +
|        |           |     |     |     |     |           |  |  |  |  |  |  |  |     |  |     |              |           |  |
+  +--+  +--+--+--+--+--+  +--+--+--+  +--+--+  +--+--+--+--+  +  +  +  +  +--+  +  +  +--+  +  +--+--+--+  +  +--+--+  +  +
|     |                 |     |        |        |              |  |     |        |     |  |     |     |     |     |  |     |
+--+  +--+--+--+--+--+  +--+  +  +  +  +  +--+--+  +--+--+--+--+--+--+  +--+--+--+--+--+  +--+--+  +  +  +--+--+  +  +--+--+
|     |     |        |     |  |  |  |  |  |        |           |     |           |        |        |  |           |     |  |
+  +--+  +  +--+--+  +  +  +  +--+  +  +  +--+--+  +  +--+--+  +  +  +--+--+--+  +  +--+  +--+  +--+  +--+--+--+--+  +  +  +
|        |           |  |  |        |  |  |        |        |     |           |     |  |  |     |  |  |              |     |
+--+--+--+--+--+  +--+  +--+--+--+--+  +  +  +--+  +--+--+  +--+--+--+--+  +--+--+--+  +  +  +--+  +  +--+--+  +--+--+--+  +
|              |  |     |           |  |  |  |     |     |  |           |              |     |     |           |     |     |
+  +--+--+--+  +  +  +--+  +--+--+  +  +  +  +--+--+  +  +  +  +--+--+  +--+  +--+--+  +--+--+  +--+--+--+--+--+  +--+  +--+
|  |           |  |        |     |     |  |           |  |  |  |     |  |  |  |              |                 |        |  |
+  +  +--+--+  +  +--+--+--+--+  +--+--+  +  +--+--+--+  +  +  +  +  +  +  +  +--+--+--+  +--+  +--+  +--+--+  +  +--+--+  +
|  |     |  |  |     |              |  |  |        |     |     |  |  |  |  |           |  |     |  |  |     |  |           |
+  +--+  +  +  +--+  +  +--+--+--+  +  +  +--+--+--+  +--+--+--+  +--+  +  +--+--+--+  +--+  +--+  +  +  +  +  +--+--+--+  +
|     |  |        |  |  |        |     |           |           |     |              |        |     |  |  |     |  |     |  |
+--+  +  +--+--+--+  +  +  +  +--+--+  +--+--+--+  +--+--+--+  +  +  +--+--+--+--+  +--+--+--+  +  +  +  +--+--+  +  +  +  +
|  |  |              |  |  |     |     |        |  |           |  |              |        |     |  |  |           |  |     |
+  +  +--+--+--+--+--+  +  +--+  +  +--+  +--+  +  +  +--+  +--+  +--+--+--+--+  +--+--+  +--+  +  +  +--+--+--+--+  +--+--+
|     |                 |     |  |  |     |     |  |  |     |     |        |           |        |  |                 |     |
+  +--+--+  +--+--+--+--+--+  +  +  +  +--+--+--+  +  +--+--+  +--+  +--+  +  +--+--+  +--+--+--+  +--+--+--+--+--+--+  +  +
|           |        |        |  |     |           |        |        |  |  |  |        |           |                    |  |
+--+--+--+--+  +  +--+  +--+--+  +--+  +  +--+--+--+  +--+  +--+--+--+  +  +  +  +--+--+  +--+--+--+--+  +--+--+--+--+--+  +
|        |     |     |        |     |  |     |           |     |        |  |  |  |        |              |           |     |
+  +--+  +  +--+--+  +--+--+  +--+  +  +--+  +--+--+--+--+--+  +  +  +  +  +  +  +  +--+--+--+--+  +--+--+  +  +--+  +  +--+
|     |  |  |        |        |  |  |     |                 |     |  |  |  |  |  |  |              |     |  |     |  |     |
+--+  +  +  +  +--+  +  +--+--+  +  +--+  +--+--+--+--+--+  +  +--+  +--+  +  +--+  +  +--+--+--+--+  +--+  +--+  +--+--+  +
|     |     |  |     |           |     |     |              |     |     |  |     |  |  |  |        |        |  |           |
+  +--+--+--+  +--+--+--+--+  +--+  +--+  +--+  +--+--+--+--+--+  +--+  +  +--+  +  +  +  +  +  +  +  +--+--+  +--+--+--+--+
|  |        |  |     |        |     |     |     |     |        |  |  |        |  |  |  |     |  |  |                       |
+  +  +  +--+  +  +  +  +--+--+  +--+  +--+  +--+  +  +  +  +--+  +  +--+--+--+  +  +  +  +--+  +--+--+--+--+--+--+--+--+  +
|  |  |     |  |  |     |     |     |     |        |  |  |        |     |        |     |     |              |              |
+  +--+--+  +  +  +--+--+--+  +--+  +--+  +--+--+--+  +--+  +--+--+  +  +  +--+--+--+--+--+  +--+  +--+--+--+  +--+--+--+--+
|           |  |              |  |     |        |  |     |           |  |  |              |  |  |     |     |              |
+--+--+--+  +  +--+--+--+--+  +  +  +  +--+--+  +  +--+  +--+--+--+--+  +  +  +--+--+  +  +  +  +--+  +  +  +--+--+--+--+  +
|  |     |  |              |     |  |  |        |     |  |        |     |     |     |  |  |        |     |  |        |     |
+  +  +  +  +--+--+--+--+  +--+  +  +--+  +--+--+--+  +  +  +--+  +  +--+--+--+  +  +  +--+--+--+  +--+--+  +  +--+  +  +--+
|  |  |     |           |        |     |              |  |  |     |  |           |  |  |           |     |     |     |     |
+  +  +--+--+  +--+  +  +--+--+--+--+  +--+--+--+  +--+  +  +--+--+  +--+  +--+  +--+  +  +--+--+--+  +--+--+--+  +--+--+  +
|     |        |     |        |        |           |     |        |        |  |  |     |  |  |        |        |           |
+  +--+--+--+--+  +--+--+--+  +  +--+  +  +--+--+--+  +--+--+--+  +--+--+--+  +  +  +--+  +  +  +--+  +  +--+  +--+--+--+--+
|                 |           |     |  |     |     |           |  |              |  |     |  |     |  |     |              |
+--+--+--+--+--+--+  +--+--+--+--+  +--+--+  +  +--+--+--+--+  +  +  +--+--+--+--+  +  +--+  +--+  +  +--+  +--+--+--+--+  +
|           |     |              |        |  |              |  |     |        |  |  |  |  |     |  |              |        |
+  +--+  +--+  +  +--+--+--+--+  +--+  +--+  +--+--+  +  +--+  +  +--+  +--+  +  +  +  +  +  +  +  +--+--+--+--+--+  +--+  +
|  |  |        |     |        |     |     |           |  |     |        |     |  |     |     |     |                 |  |  |
+  +  +--+--+--+  +  +  +--+  +--+  +--+  +--+--+--+--+  +  +--+--+--+--+  +--+  +--+--+  +--+--+--+  +--+--+--+--+--+  +  +
|              |  |  |  |     |        |     |        |  |  |     |        |           |           |     |           |     |
+--+--+--+--+  +  +--+  +  +--+  +--+--+  +--+  +  +--+  +  +  +  +  +--+--+  +--+--+  +--+--+--+--+--+  +  +--+--+--+  +--+
|        |     |     |  |        |  |     |     |        |  |  |  |           |     |                    |  |        |  |  |
+  +  +--+  +--+--+  +  +--+--+--+  +  +--+  +--+--+--+--+  +--+  +--+--+--+--+  +--+--+--+--+--+--+--+--+  +  +--+  +  +  +
|  |              |                 |                    |     |                                                  |        |
+--+--+--+--+--+--+--+--+--+--+--+--+--+--+--+--+--+--+--+--+  +--+--+--+--+--+--+--+--+--+--+--+--+--+--+--+--+--+--+--+--+
