+--+--+--+--+--+--+--+@@+--+--+--+--+--+--+--+
|  |     |           |@@@@@@@@|           |  |
+  +  +  +--+--+  +  +  +--+@@+  +--+--+  +  +
|     |     |     |  |     |@@|        |  |  |
+--+--+--+  +--+--+  +--+--+@@+--+--+  +  +  +
|@@@@@@@@|     |     |@@@@@|@@|@@@@@@@@|     |
+@@+--+@@+--+  +  +--+@@+@@+@@+@@+--+@@+--+--+
|@@@@@|@@@@@|  |     |@@|@@@@@|@@|@@@@@      |
+--+@@+--+@@+  +--+  +@@+--+--+@@+@@+  +--+  +
|@@@@@|@@@@@|  |     |@@@@@@@@@@@|@@|     |  |
+@@+--+@@+--+  +  +--+--+--+--+--+@@+--+  +  +
|@@   |@@|     |           |@@@@@|@@|     |  |
+@@+  +@@+  +  +--+--+--+  +@@+@@+@@+--+--+  +
|@@|  |@@|  |           |   @@|@@|@@@@@@@@|  |
+@@+--+@@+  +--+--+--+  +--+@@+@@+--+--+@@+  +
|@@@@@|@@|  |        |  |@@@@@|@@|   @@@@@|  |
+--+@@+@@+  +--+--+  +  +@@+--+@@+--+@@+  +  +
|@@@@@|@@@@@@@@|     |  |@@@@@|@@@@@@@@|  |  |
+@@+--+--+--+@@+  +  +  +--+@@+--+--+--+--+  +
|@@@@@|@@@@@|@@|  |        |@@@@@|           |
+--+@@+@@+@@+@@+--+--+--+--+--+@@+  +--+--+--+
|@@@@@|@@|@@|@@@@@@@@@@@|@@@@@|@@|  |        |
+@@+--+@@+@@+--+--+--+@@+@@+@@+@@+  +--+  +  +
|@@|@@@@@|@@@@@@@@@@@|@@@@@|@@@@@|        |  |
+@@+@@+--+--+--+--+@@+--+--+--+--+--+--+--+  +
|@@|@@@@@@@@@@@|   @@|        |        |     |
+@@+--+--+--+@@+  +@@+  +--+  +  +--+  +  +--+
|@@|@@@@@@@@@@@|  |@@|  |        |  |  |     |
+@@+@@+--+--+--+  +@@+  +  +--+--+  +  +--+  +
|@@@@@|           |@@@@@|        |     |     |
+--+--+--+--+--+--+--+@@+--+--+--+--+--+--+--+
